rules = "Spielregeln"
close = "Schließen"
next = "Nächstes"
prev = "Vorheriges"
ok = "OK"
cancel = "Abbrechen"
fullscreen = "Vollbildmodus"
niceCursor = "Netter Cursor"
options = "Optionen"
newGame = "Neues Spiel"
loadGame = "Spiel laden"
topScores = "Ruhmeshalle"
about = "Über"
exit = "Quit"
einsteinPuzzle = "Einstein-Puzzle"
version = "Version 2.0"
copyright = "Copyright (c) 2003-2005 Flowix Games"
anonymous = "Anonymous"
enterName = "Bitte Namen eingeben:"
empty = "-- Leerer Eintrag --"
enterGame = "Bitte Spielnamen eingeben:"
saveError = "Fehler beim Spiel-Speichern"
saveGame = "Gespeichertes Spiel"
paused = "SPIEL UNTERBROCHEN"
won = "GLÜCKWUNSCH, SIE HABEN GEWONNEN!"
startNew = "Neues Spiel"
tryAgain = "Nochmal"
loose = "SIE HABEN VERLOREN"
iddqd = "DIES IST NICHT DOOM, LUKE!"
pause = "Pause"
switch = "Umschalten"
save = "Speichern"
help = "Hilfe"
loading = "Lade....  Bitte warten...."
einsteinFlowix = "Einstein-Puzzle von Flowix Games"
enableSound = "Audio aktivieren"
expired = "Diese Beta ist abgelaufen. Bitte laden Sie die Aktualisierung von http://games.flowix.com herunter"
volume = "Lautstärke:"

